XXXXXXXXXXXXXXXXXXXXX
P       X           X
X XXX XXX XXXXXXX XXX
X   X X   X     X   X
X X XXX XXXXXXX XXX X
X   X   X         X X
X XXX XXX XXXXXXX X X
X       X X       X X
X XXXXX X XXXXXXX X X
X X   X   X     X X X
X X X XXX X XXX X X X
X X X X   X X X X X X
X X XXXXX X X X XXX X
X   X   X X X     X X
X XXX X XXX XXXXX X X
X   X X   X X   X X X
X X X XXX X X X X X X
X   X   X X   X X X X
X XXXXX X XXXXX X X X
X                   K
XXXXXXXXXXXXXXXXXXXXX
