XXXXXXXXXXXXXXXXXXXXXXXXXXXXXXXXXXXXXXXXXXXXXXXXXXX
P X             X     X     X     X       X       X
X X X X XXXXXXX X XXX X X XXX X XXX X XXX X XXXXXXX
X X X X X     X X   X   X X   X     X   X X       X
X X X XXX XXX X XXX XXXXX X XXXXXXXXX X X X XXXXX X
X   X     X   X   X X   X X X   X   X X X X     X X
X XXXXXXXXX XXXXX X X X XXX X X X X XXX X XXXXXXX X
X X         X X   X   X     X X   X     X         X
XXX XXXXXXXXX X XXX XXXXXXXXX XXX XXXXXXXXXXXXXXX X
X   X     X   X   X   X       X X X   X   X     X X
X XXX XXX X X XXX XXXXX XXXXXXX X X X X X X XXX X X
X   X X     X X         X     X   X X   X X X   X X
X X X XXXXXXXXX XXXXXXXXXXX XXX XXX XXXXX XXX X X X
X X X   X       X   X       X   X X     X   X X X X
X X X X X XXXXXXX X X XXX XXX XXX XXXXX XXX X XXX X
X X X X         X X X X X X   X   X   X X   X     X
X X X XXXXXXXXXXX X X X X X XXX XXX X X X XXXXXXX X
X X X     X       X X   X   X   X   X   X X     X X
X X XXXXXXX XXXXXXX XXX XXXXX X X XXXXXXX XXX X XXX
X X X             X   X   X   X X X           X   X
X X X XXXXXXXXXXX XXX XXX X XXX X XXXXXXXXXXXXXXX X
X X   X     X   X   X X   X X   X X     X       X X
X XXXXX XXX X X XXXXX X XXX X X X X XXX X X XXXXX X
X     X   X X X       X   X X X X   X   X X       X
XXXXX XXX XXX XXXXXXXXXXX X X X XXXXX XXX XXXXXXXXX
X   X   X X   X       X   X X X   X   X X     X   X
X X XXX X X XXX XXXXXXX XXXXX XXXXX XXX XXXXX X XXX
X X       X X           X     X     X     X   X   X
XXXXXXXXXXX XXXXX XXXXXXX X XXX XXXXX XXXXX XXXXX X
X   X       X   X       X X   X   X X       X     X
X X X XXXXX X X XXXXXXX XXXXX XXX X X XXXXXXX X X X
X X   X     X X     X X   X     X X X       X X X X
X XXXXXXXXXXX XXXXX X XXX X XXXXXXX XXXXXXX X X X X
X X           X     X   X X   X         X   X X X X
X X XXXXXXXXXXX XXXXX XXX XXX X X XXXXX X XXXXX X X
X X X   X     X     X       X X X     X X X     X X
X X X X X XXX XXXXX XXXXXXX X X XXXXX XXX XXX XXX X
X X X X   X   X   X X     X   X   X X     X   X X X
X X XXXXXXX XXX X X X XXX XXXXXXX X XXXXXXX XXX X X
X   X       X   X   X X X     X   X         X   X X
X XXX XXXXX X XXXXX X X XXXXX X XXX XXXXXXXXX X X X
X X       X X   X   X X   X   X X   X     X   X X X
X XXXXXXX XXXXX X XXX X X X XXX X XXX XXXXX XXX X X
X     X   X     X X X X X X     X   X   X   X X   X
XXXXX X X X XXXXX X X XXX XXXXXXX X X X X XXX XXXXX
X     X X X X       X   X   X     X X X   X       X
X XXXXX X X XXXXXXXXXXX X X XXX XXX XXX XXXXXXX XXX
X     X X X   X       X   X   X   X   X X     X   X
XXXXX X X XXX X XXXXX XXXXXXX XXXXXXX X XXX X XXX X
X       X   X       X                 X     X     K
XXXXXXXXXXXXXXXXXXXXXXXXXXXXXXXXXXXXXXXXXXXXXXXXXXX
