XXXXXXXXXXXXXXXXXXXXXXXXXXXXXXXXXXXXXXXXXXXXXXXXXXXXXXXXXXXXXXXXXXXXXXXXXXXXXXXXXXXXXXXXXXXXXXXXXXXXXXXXXXXXXXXXXXXXXXXXXXXXXXXXXXXXXXXXXXXXXXXXXXXXXXXXXXXXXXXXXXXXXXXXXXXXXXXXXXXXXXXXXXXXXXXXXXXXXXXXXXXXXXXXXXXXXXXXXXXXXXXXXXXXXXXXXXXXXXXXXXXXXXXXXXXXXXXXXXXXXXXXXXXXXXXXXXXXXXXXXXXXXXXXXXXXXXXXXXXXX
P   X         X         X           X       X                   X       X       X                   X           X     X       X       X     X       X       X X       X           X   X   X       X         X   X                 X   X X       X     X                       X                         X   X
X X XXX XXXXX XXX XXXXX XXXXXXXXX X XXXXXXX X XXXXXXXXX XXX XXX X X XXX XXXXX X XXX XXXXXXXXXXXXXXXXX X XXXXXXXXX XXX X XXX XXX X XXX XXX X X XXX X XXXXX X X X XXX X X XXXXX XXX X X X XXX X XXX X XXXXXXX X X X XXXXX XXXXXXXXX X X X X XXXXX X X X XXXXXXX XXXXXXXXX XXXXX XXXXX XXXXX XXXXXXXXXXXXX XXX X
X X     X   X     X   X X     X   X         X     X   X X   X X X X   X       X   X       X       X   X X     X     X     X     X X X   X X   X   X       X X X X X X X X   X   X   X X     X X X X X   X X   X   X     X       X X X   X X X   X X X X     X       X X X         X X     X   X       X   X X
X X XXXXX X XXXXXXX XXX X XXX X XXXXXXXXXXX XXXXX X X X X XXX X X XXX XXXXXXXXXXX X XXXXX X XXXXX X XXX X XXX X XXXXXXXXXXXXXXXXX X XXX X XXXXX XXXXXXXXXXX X X X X X XXX X XXX XXXXX X XXXXX X X X X X X XXXXX XXX XXXXX X XXXXX X XXXXX X X XXX X X X XXX XXXXXXX X X XXXXXXXXX X X XXXXX X X XXXXX XXX X X
X X X     X     X       X   X   X X         X     X X X X X   X X X   X         X X     X X X   X   X X   X X   X   X             X   X X   X   X   X     X X     X X   X X     X   X X   X   X X X X X   X   X   X X X   X     X X   X   X X X   X X X   X   X   X   X       X   X X   X   X X X X     X   X
X X X XXXXXXXXX X XXXXXXXXX XXXXX X XXXXXXXXX XXXXX X XXX XXX X XXX X X XXXXXXX X XXX XXX X XXX XXXXX XXXXX XXXXX X X XXXXXXXXXXXXX X X XXX X XXXXX X XXX X XXXXXXX XXX X XXXXXXX X X XXXXX XXX X X X XXX X X XXXXX X X XXXXXXX X XXX X XXX X X XXX X X X XXX X X XXX XXXXXXX X XXXXXXX X XXX X X X XXX XXX X
X X X X     X   X     X     X     X   X     X   X X X     X   X   X X X       X X   X X   X   X   X           X X X X X           X X   X   X X     X X   X X     X   X   X   X   X   X   X X   X X X X   X X       X X X     X X   X       X   X X X X X X X X X X         X X X       X X X X X X X     X X
X XXX XXXXX X XXXXXXX X XXXXX X XXXXX X XXX XXX X X XXXXXXX XXXXX X XXXXXXXXX X XXX XXX XXXXX X X X X XXXXXXX X X X X X XXXXXXXXX X XXXXXXXXX X XXXXX X XXX X XXX X X XXXXXXX X XXXXXXX X X XXX X X X X XXX XXXXXXXXX X XXXXX X XXX XXXXXXXXXXX X X X XXX X X X X XXXXXXXXX X X X X XXXXX X X X X X XXX XXX X
X   X     X X   X   X   X     X       X   X X   X X X       X     X           X X       X     X X   X   X     X X X   X X     X   X X         X X     X       X   X X X     X           X   X   X X   X   X   X       X       X   X   X       X   X X X   X     X     X   X X X X X   X     X     X   X X   X
X X XXXXX X XXX X XXX XXXXXXXXXXXXXXXXX XXX X XXX X X XXXXXXX XXXXX XXXXXXXXXXX XXXXXXXXX XXXXXXXXXXXXX X XXXXX X XXXXX X XXX X XXX X X XXXXXXX X XXXXXXXXXXXXX XXXXX X XXX X XXXXXXXXXXXXXXX XXX X XXXXXXXXX X XXX X XXXXXXX XXX XXX X XXXXX XXX X X X XXXXXXXXXXXXX X XXX X X XXXXX XXXXXXXXXXXXXXX X X XXX
X X   X X X   X X     X                 X   X     X X         X   X X     X     X       X X             X   X   X X     X   X X X X X X   X       X         X   X   X X   X X   X       X   X   X X X       X X   X X X   X   X X   X   X   X   X X X X X     X     X X     X X       X         X     X X   X
X X X X X X X X XXXXXXX XXXXXXXXXXXXXXXXX XXX XXXXX X XXXXXXXXXXX X X XXX X XXX X XXXXX X X XXXXXXXXXXXXXXX X X X X X XXX XXX X X X XXXXX X XXXXXXX XXXXXXX X XXX X X XXX X XXXXX XXXXX X X X X X XXX XXXXX X XXXXX XXX X X XXX XXX XXXXXXX XXX XXX X X X XXX X XXX X X XXXXX X XXXXXXX XXXXX X X XXXXXXXXX X
X X X   X X X X         X   X         X   X   X     X   X     X   X X X   X   X X X   X   X     X     X   X   X X X X     X   X   X       X   X     X   X   X     X X   X X     X X   X X X X X     X X       X   X     X   X   X             X     X X   X   X   X X X X X   X X       X   X X X X     X   X
XXX XXX X XXX XXXXXXXXXXX X X XXX X XXX X X XXX XXXXXXX X XXX X XXX X XXXXXXX X X XXX XXXXX XXX XXXXX X X XXXXX X X XXXXXXX XXX XXX XXXXXXXXX X XXXXX X X XXXXXXXXX XXX X XXXXX X X X X X X XXXXXXX X XXXXXXXXX X XXXXX XXXXX X X XXX XXXXXXX XXXXXXX XXXXX XXXXXXX X X X X XXXXX XXXXXXX X XXX X X XXX X XXX
X   X   X   X         X   X X X   X X   X X X X X     X   X   X X   X X   X   X X   X   X     X   X   X X       X X X X     X   X   X   X     X   X   X   X       X   X     X   X X X X   X       X   X     X   X X   X       X X X   X   X         X     X     X   X X   X             X X     X X   X X X X
X X XXXXXXX XXXXXXX X XXX X XXX XXX X XXXXX X X XXX XXXXXXX XXX X XXX X X X XXXXXXX X X X XXXXXXX X X X XXXXXXXXX X X X XXXXXXXXX XXX X X XXXXXXX X XXXXXXX XXXXX XXX XXX XXX X X X X XXXXXXXXXXX XXX X XXX X XXX X X XXXXXXX XXX XXXXX X XXXXXXX XXXXXXX XXXXX X XXX XXXXX XXXXX XXXXX X XXXXXXX XXX X X X X
X X X     X         X     X   X   X X   X     X X   X       X       X X X   X       X X   X X     X X X X   X   X X   X     X     X   X X       X X X     X X       X   X X   X X   X X   X     X   X X X X   X   X X     X X X   X     X X     X X       X     X   X     X X   X X   X X   X       X X   X X
X XXX XXX XXXXXXXXXXXXXXXXXXX X X XXXXX X XXXXX X X X XXXXXXXXXXXXX X X XXX X XXXXXXX XXXXX X XXXXX XXX XXX X X X XXX XXXXX X XXXXX XXXXXXXXXXXXX X X X X X XXXXX XXXXX XXX XXXXX XXXXX X X XXX XXX X X X XXXXX XXX XXXXX X X X XXX XXXXX X XXX XXX XXXXXXX XXXXX X XXXXX X X X X X X XXXXX X X XXXXX XXXXX X
X X   X X       X       X     X X     X   X     X X X X           X   X X   X X     X X     X     X X       X X   X     X X X X X   X           X X X X X X     X X   X X   X   X X     X X   X   X X X   X   X   X X X   X   X     X     X   X X   X   X   X     X     X X X X X X X       X X             X
X X XXX XXX XXXXX XXX X X XXXXX XXXXX XXXXX XXXXX XXX XXX XXXXXXX XXX X XXX X XXX XXX X X XXXXXXX X X XXXXXXX XXXXXXXXX X X X X X XXX XXX XXXXX X X XXX X XXX X XXX X X X XXX X X X XXXXX XXX XXX X XXXXX XXX XXX X X X XXX XXXXXXXXX XXXXXXX X X XXX X XXX XXX XXXXX X X XXX X XXX XXXXXXXXX XXXXXXXXXXXXXXX
X X X     X   X   X   X X X   X     X   X X X       X   X X   X   X X X   X X   X       X X   X   X   X       X     X     X X   X X     X X   X X X     X   X X X   X   X     X   X X   X X   X X X X   X X     X   X X   X     X     X       X   X   X   X   X   X   X X X   X     X   X   X X   X X       X
X X XXX XXXXX X XXX XXXXX X XXXXX XXX X X X X XXXXX XXX X X XXX XXX X XXX X XXX XXXXXXXXXXX X X XXX XXX XXXXXXX XXX X XXXXX XXX X XXXXXXX XXX X X XXXXXXXXX X X X XXXXXXXXXXXXXXX X X X X X XXX X X X X X X XXX XXXXX XXX XXXXX X XXX X XXXXXXXXXXX XXXXX X X XXXXX X XXX X XXXXXXX X X X X X X X X X XXXXX X
X X   X     X   X X     X X   X   X   X   X X X   X X   X X X   X X   X   X   X         X   X X X X X X X   X   X X X   X   X X X X     X   X X X   X   X   X X X X             X X X X X   X   X X   X X X X     X     X X   X X   X X     X       X     X X   X   X X   X   X     X X X X     X   X X     X
X XXX XXX X XXXXX XXXXX X X X X XXX XXXXX X X X X X X XXX X X XXX X XXX XXXXX XXXXXXXXX X XXX X X X X X X X X XXX X XXXXX X X X X X XXX XXX X X XXX X X X XXX X X X X XXXXXXXXX XXX X X XXXXX X X X XXX X X XXXXX XXXXX X X X XXX X XXXXXXX X XXXXXXX XXXXXXXXX X XXXXX XXXXX XXXXXXX X XXXXXXXXXXXXX X XXXXX
X   X   X X   X       X X X X     X X     X X X X   X   X X X   X X   X     X     X     X X X   X   X X   X X   X   X     X   X X   X X     X X X   X X   X   X   X X   X     X     X X       X X X X X   X   X X X   X X   X   X X       X X X     X           X X   X   X   X     X X       X       X     X
X X XXX X XXX X XXXXX X X X XXXXXXX XXXXX X X X XXXXXXX X X XXX X XXX XXXXX XXXXX X XXXXX X XXXXX XXX XXXXX X X XXX X X XXXXXXX XXXXX XXXXXXX X X XXX XXXXX XXXXXXX XXX XXX X XXXXXXXXXXX XXXXXXX X X XXXXX X X X X X X XXXXXXX XXX XXX XXX X XXXXX XXXXXXXXXXXXX X X XXX X XXX XXX X XXXXXXX X XXXXXXXXX X X
X X   X X   X   X     X   X X     X     X X X X   X   X   X X   X       X   X   X X       X     X     X   X X X   X   X X       X         X   X   X X   X       X     X X   X     X       X       X   X   X X X X   X X X     X   X   X     X   X     X   X   X     X   X X       X X       X       X   X X X
XXX X X XXXXXXXXX XXXXXXXXXXX XXX X XXX X X XXXXX X X XXXXX X XXXXXXXXXXX XXX XXX XXXXXXXXXXXXX XXXXX XXX X X XXX XXXXX X XXXXXXXXXXXXX X X X XXXXX XXX X XXXXX XXXXXXX X X XXXXX X X XXXXX XXXXXXXXX X X XXX X XXXXX X X XXX X X XXX XXXXXXXXX X XXX X X X X X XXXXX X X XXXXX XXX XXXXXXX XXXXXXXXX X XXX X
X   X X       X   X         X X   X X X X X     X   X         X   X       X       X                 X X   X X   X     X X X             X X X       X X X X   X       X X X X   X X X   X   X   X       X   X X X       X X X X X   X X       X X   X   X X X   X     X X     X X   X     X   X X     X   X X
X XXX XXXXXXX X XXX XXX XXX X X XXX X X X XXXXX XXXXXXXXXXX XXX X X XXXXXXX XXXXXXX XXXXX XXX XXXXXXX X X X XXX XXXXX XXX XXXXXXX XXXXXXX X XXX XXX X X XXX X XXXXXXX X X XXX X XXX XXX X XXX X XXXXXXXXXXX X X X XXXXXXX X X XXX X X XXXXX X X XXX XXXXXXX XXXXX XXX XXXXXXX X X X X XXX XXX X X XXXXXXX X X
X   X   X X   X   X   X X X   X X     X X   X   X         X   X X   X     X   X   X X   X X   X       X X X X   X   X X   X   X   X     X X X X   X   X     X   X   X   X     X     X   X     X           X   X   X   X   X     X X X     X X X   X X       X   X   X X   X   X X X X   X X     X X X     X X
XXX XXX X X XXXXX X XXX X XXXXX XXXXX X XXX X XXX XXXXXXX XXX X XXXXX X XXXXX X X X X X X XXXXX XXXXXXX XXX X XXXXX X X XXX X X XXXXX X X X X XXX XXX XXXXXXXXX X X XXXXX XXXXXXXXXXX XXXXXXXXXXXXXXXXXXX XXXXXXX X X X XXXXXXX XXX XXXXX X X X X X X XXXXXXX XXXXX XXX X X XXX X XXXXX X X XXXXX X X XXXXX X
X   X X   X     X   X   X   X   X   X X X X X X   X     X   X   X     X X       X X   X X             X X   X X     X       X   X   X X   X   X X   X X       X X X                 X         X         X   X   X   X X     X       X   X   X X X X   X   X       X   X X   X   X       X X X X   X         X
X XXX XXX XXXXX XXX X XXX XXX XXX X XXX X X X X XXX XXX XXX XXXXX XXXXX X XXXXXXXXXXXXX XXXXXXXXXXXXX X X XXX XXX XXXXXXXXXXXXXXX X X XXXXXXX X XXX X X XXXXX X X XXXXXXXXXXXXXXXXX XXX XXXXX XXX XXXXX XXX X X XXXXXXXXXXX XXXXXXXXX X XXXXX XXX X XXX X XXXXXXX XXX X XXXXX XXXXXXXXXXX X X X XXXXXXXXXXX X
X X           X   X X X   X   X   X     X   X X X   X X X   X   X   X X   X   X     X       X   X   X X X X X   X     X X         X X X   X X     X X X X   X   X X               X   X X         X   X   X X X           X     X     X X   X X   X     X   X       X   X   X   X     X   X X X       X     X
X XXXXXXXXXXX XXX XXX X X X XXXXX X XXXXX XXX X XXX X X X XXXXX XXX X XXXXX X X XXX X XXXXXXX X X XXX X X X XXX XXX X X X XXXXXXXXX X X X X XXX XXX X X XXX XXXXXXX XXXXX XXXXXXX XXXXX X XXXXXXXXX X XXXXX X XXXXXXXXXXX XXXXX X XXXXX X X X X XXXXXXXXXXX X XXXXXXXXXXX X XXX X XXX X XXX X XXXXXXX X XXXXX
X         X   X X X   X X   X   X X X   X X X   X   X   X     X           X X     X X X X     X X       X X   X     X   X   X   X   X   X   X   X   X X       X   X     X X   X     X   X X   X     X X     X   X       X       X     X   X   X     X       X X       X   X     X X   X       X     X X   X X
X XXXXXXX XXX X X X XXXXX XXX X X XXX X X X XXXXX XXX XXXXXXX X XXXXXXXXXXX XXXXX X X X X XXXXX XXXXXXX X XXX X XXXXXXXXXXX X X X XXX XXXXXXX XXX XXXXXXXXXXX X X X XXX XXX X XXXXX X XXX X X X XXXXX X XXXXXXX X XXX XXXXXXXXXXXXXXX XXXXXXXXXXXXX X XXXXXXX X XXX X XXX XXXXXXX XXX XXXXXXX X XXX X XXX X X
X     X X   X X X X     X X   X X     X X   X     X X X   X   X   X         X   X X     X X     X   X   X X   X X   X       X X X   X X         X X         X   X X X   X   X     X X X   X X   X   X   X       X X X       X       X   X           X       X X X   X   X X     X   X       X   X   X X   X X
XXXXX X XXX X X X X XXX X X XXX X XXXXX XXX XXXXX X X X X X XXXXXXX XXXXXXXXX X XXXXXXX X X XXXXX X XXXXX X XXX X X X XXXXXXX X XXX XXX XXXXXXXXX X XXXXX X XXXXX XXX XXX XXXXXXX X X XXXXX XXXXXXX XXXXX XXXXXXX X XXXXX XXX X XXXXXXX XXXXXXX XXXXXXXXXXX X X X XXXXX X XXX XXXXX XXXXXXX X XXXXXXX X XXX X
X   X X   X X   X X   X X   X X X X     X   X     X   X X X   X     X     X X X       X X X     X X X   X X     X X X   X     X   X   X X   X X   X X   X X X   X   X       X     X X     X X       X   X     X   X     X   X X         X       X     X     X   X   X   X     X   X     X   X X       X     X
XXX X X X X XXXXX XXX X XXXXX X X X XXXXX XXX XXXXX XXX X XXX X XXXXX X X X X XXXXXXX XXX XXXXX X X X X X X XXXXX X XXX X X XXX XXXXX X X X X X XXX X X X XXX X XXX XXXXXXXXX XXXXX XXXXX X X XXXXX X X X XXX X XXXXX X XXX X XXXXXXXXXXX XXXXXXXXXXX X XXXXX XXXXX X XXXXXXXXX X X XXX X XXXXX XXXXXXXXXXX X
X   X X X X   X   X   X X   X   X X     X     X   X X   X   X   X     X X   X X     X     X       X   X   X     X X     X X X X X   X X   X   X     X X   X   X   X           X   X   X   X X     X X X X X   X       X X X X X         X           X X X       X   X   X       X X X   X X     X     X X   X
X X X X X XXX X XXXXXXX XXX X XXXXX XXX XXXXXXX X X X XXX X XXXXXXXXXXX X XXX X XXX X XXXXXXXXXXXXXXXXXXX XXXXXXX XXXXXXXXX X X X X X XXXXXXX XXXXXXX XXXXX XXX XXXXXXXXXXXXXXX X XXX X XXX X XXX X X X XXX XXXXXXXXXXX X X X XXXXX XXX X XXXXXXXXX X X XXXXXXXXX XXXXX X XXXXXXX XXX XXX X XXXXXXX X X X XXX
X X X X X   X X X   X   X   X     X   X     X   X   X   X X         X   X X   X X X X X         X         X   X   X     X   X X X X     X   X       X   X   X X       X       X X   X X X   X X   X X X   X   X X     X X X X X     X X X X       X X X     X   X X   X X   X   X   X X X   X X     X   X X X
X XXX X XXX X X X X X XXX XXXXXXX XXXXXXXXX X XXXXXXXXXXX XXXXXXXXX X XXX X XXX X X XXX XXXXXXX XXXXXXXXXXX X X XXXXX X X XXX X X XXXXXXX X XXXXXXX XXX X XXX XXX XXXXX X XXXXX X XXX X X XXXXX XXX X XXX XXX X X XXX X X X X X XXXXX X XXX XXXXX X X XXXXX X X X X X X XXX X XXXXX X X XXXXX X X XXXXXXX X X
X       X   X     X   X                     X             X           X   X       X           X             X         X   X     X         X           X         X       X       X     X         X     X       X     X     X     X           X       X         X   X X       X         X         X           K
XXXXXXXXXXXXXXXXXXXXXXXXXXXXXXXXXXXXXXXXXXXXXXXXXXXXXXXXXXXXXXXXXXXXXXXXXXXXXXXXXXXXXXXXXXXXXXXXXXXXXXXXXXXXXXXXXXXXXXXXXXXXXXXXXXXXXXXXXXXXXXXXXXXXXXXXXXXXXXXXXXXXXXXXXXXXXXXXXXXXXXXXXXXXXXXXXXXXXXXXXXXXXXXXXXXXXXXXXXXXXXXXXXXXXXXXXXXXXXXXXXXXXXXXXXXXXXXXXXXXXXXXXXXXXXXXXXXXXXXXXXXXXXXXXXXXXXXXXXXXX
