XXXXXXXXXXXXXXXXXXXXXXXXXXXXXXX
P   X       X           X     X
X XXX XXX XXX XXXXXXXXX X XXX X
X       X   X X   X   X     X X
X XXXXXXXXX X X XXX X XXXXXXX X
X   X     X     X   X         X
XXXXX XXX X XXXXX XXXXXXXXXXXXX
X     X   X X X   X           X
X XXXXX XXX X X X X XXXXXXXXX X
X   X   X   X X X X X   X     X
X X XXX XXX X X X X XXX X XXX X
X X   X   X   X X X     X   X X
X XXX XXX XXX X XXXXX XXXXX X X
X X   X X X X X X     X     X X
XXX XXX X X X X X XXXXX XXXXX X
X   X   X X   X   X   X     X X
X XXX X X XXXXX XXX X XXXXX XXX
X   X X       X   X X     X   X
X X XXXXXXXXX XXX X XXXXX XXX X
X X     X   X X     X   X   X X
X XXXXX X X X XXXXXXX X XXX X X
X   X X   X X       X X     X X
XXX X XXXXX XXXXXXX X XXXXXXX X
X   X     X X     X X     X   X
X XXX X XXX XXXXX X XXXXXXX X X
X X   X X   X   X         X X X
X XXX X X XXX X XXXXX XXX X X X
X     X X     X     X X X   X X
XXXXXXX XXXXXXXXXXX XXX XXXXX X
X                 X     X     K
XXXXXXXXXXXXXXXXXXXXXXXXXXXXXXX
